{
  "playerStartIndex": [2,1],
  "mapSize": [56,32],
  "background": "/levels/lvl2/background.png",

  "blockAtlas": "/levels/lvl2/blocks.png",
  "blockTypes": 10,

  "graphicMap": [
    [1,1,1,1,1,1,1,1,1,1,1,1,1,1,1,1,1,1,1,1,1,1,1,1,1,1,1,1,1,1,1,1,1,1,1,1,1,1,1,1,1,1,1,1,1,1,1,1,1,1,1,1,1,1,1,1],
    [1,0,0,0,1,1,1,1,1,1,1,1,1,0,0,0,0,0,0,0,0,0,0,1,1,1,1,1,1,1,0,0,0,0,0,0,0,0,0,0,0,0,0,0,0,0,0,0,0,0,0,0,0,0,1,1],
    [1,0,0,0,1,1,1,1,1,0,0,0,0,0,0,0,0,0,0,0,0,0,0,0,0,0,0,0,0,0,0,0,0,0,0,0,0,0,0,0,0,0,0,0,0,0,0,0,0,0,0,0,0,0,0,1],
    [1,0,0,0,1,1,1,0,0,0,0,0,0,0,0,1,1,1,1,0,0,0,0,0,0,0,0,0,0,0,0,0,1,1,1,1,1,1,1,1,1,1,1,1,1,1,1,1,1,1,1,1,1,1,1,1],
    [1,0,0,0,1,0,0,0,0,0,0,1,1,1,1,1,0,0,1,1,1,1,1,0,0,0,0,0,0,0,1,1,1,0,0,0,0,0,0,1,1,1,1,1,1,1,1,1,1,1,1,1,1,1,1,1],
    [1,0,0,0,1,0,0,0,0,1,1,1,0,0,0,0,0,0,0,0,0,0,1,1,1,1,1,1,1,1,1,0,0,0,0,0,0,0,0,0,0,1,1,1,1,1,1,1,1,1,1,1,1,1,1,1],
    [1,0,0,0,1,0,0,0,0,0,0,0,0,0,0,0,0,0,0,0,0,0,0,0,0,0,0,0,0,0,0,0,0,0,0,0,0,0,0,0,0,0,1,1,1,1,1,1,1,1,1,1,1,1,1,1],
    [1,0,0,0,1,1,0,0,0,0,0,0,0,0,0,1,0,0,0,0,0,0,0,0,0,0,0,0,0,0,0,0,0,0,0,0,0,0,0,0,0,0,1,1,1,0,9,0,9,0,9,0,0,0,0,0],
    [1,0,0,0,1,1,1,0,0,0,0,0,0,0,1,1,1,0,0,0,1,1,1,0,1,1,1,0,0,0,0,0,0,0,0,0,0,0,0,0,0,0,0,0,0,0,10,0,10,0,10,0,0,0,0,0],
    [1,0,0,0,1,1,1,0,0,0,1,1,1,1,1,1,1,1,0,0,0,1,1,0,1,1,0,0,1,1,0,0,0,1,1,1,0,0,0,0,0,0,0,0,0,0,9,0,9,0,9,0,0,0,0,0],
    [1,0,0,0,1,1,1,0,0,1,1,1,1,1,1,1,1,1,1,0,0,0,0,0,0,0,0,0,1,1,1,0,0,1,1,0,0,3,0,0,0,0,1,1,1,1,1,1,1,1,1,1,1,1,1,1],
    [1,0,0,0,1,1,1,2,2,1,1,1,1,1,1,1,1,1,1,1,0,0,0,0,0,0,0,0,0,0,1,0,0,0,0,0,1,3,1,1,1,1,1,1,1,1,1,1,1,1,1,1,1,1,1,1],
    [1,0,0,0,1,1,0,0,0,0,0,0,0,0,0,1,1,1,1,1,1,0,0,0,0,0,0,0,0,0,0,0,0,0,0,1,1,3,1,1,1,1,1,1,1,1,1,1,1,1,1,1,1,1,1,1],
    [1,0,0,0,1,1,0,0,0,0,0,0,0,0,0,0,1,1,1,1,1,4,4,4,4,4,4,4,4,4,4,4,4,4,4,1,1,3,0,1,1,1,1,1,1,1,1,1,1,1,1,1,1,1,1,1],
    [1,0,0,0,1,1,0,1,1,1,0,0,0,0,0,0,0,1,1,1,1,5,5,5,5,5,5,5,5,5,5,5,5,5,1,1,1,3,0,0,0,0,0,0,0,3,1,0,0,1,3,0,0,0,0,1],
    [1,0,0,0,1,0,0,1,1,1,1,0,0,0,0,0,0,0,1,1,1,1,5,5,5,5,5,5,5,5,5,5,5,1,1,1,0,3,0,0,0,0,0,0,0,3,1,0,0,1,3,0,0,0,0,1],
    [1,0,0,0,1,0,0,0,1,1,1,0,0,0,0,0,0,0,1,1,1,1,5,5,5,5,5,5,5,5,5,5,5,1,1,0,0,1,1,1,1,1,1,1,1,3,1,1,0,1,3,1,1,1,1,1],
    [1,0,0,0,1,0,0,0,0,1,1,1,0,0,0,0,0,0,0,1,1,1,1,1,1,1,1,1,1,1,5,5,1,1,1,0,0,1,3,0,1,0,0,0,0,3,1,0,0,0,3,0,1,0,0,1],
    [1,0,0,0,1,0,0,0,0,0,1,1,0,0,2,2,0,0,0,1,1,1,1,1,1,1,1,0,0,1,1,5,1,1,0,0,1,1,3,0,0,0,0,0,0,3,0,0,0,0,3,0,1,0,0,1],
    [1,0,0,0,1,0,0,0,0,0,0,0,0,0,0,0,0,0,0,1,1,1,1,1,0,0,0,0,0,0,0,6,8,0,0,1,1,0,3,1,1,1,1,1,1,1,1,1,1,1,1,0,1,1,0,1],
    [1,0,0,0,1,0,0,0,0,0,0,0,0,0,0,0,0,0,0,1,1,1,1,0,0,0,0,0,0,1,1,6,1,1,1,1,0,0,3,0,1,0,0,0,3,0,1,0,0,1,0,0,0,3,0,1],
    [1,0,0,0,1,0,0,0,0,0,0,0,0,0,1,1,0,0,0,1,1,1,0,0,0,0,0,0,0,0,1,6,1,1,1,1,0,0,3,0,0,0,0,0,3,0,1,0,0,1,0,0,0,3,0,1],
    [1,0,0,0,1,0,0,0,0,0,1,1,0,0,0,1,0,0,0,1,1,0,0,0,0,0,0,0,0,0,0,6,0,1,1,1,1,1,1,1,1,1,1,1,3,1,1,1,1,1,1,1,1,3,1,1],
    [1,0,0,0,1,0,0,0,0,0,1,1,0,0,0,0,0,0,0,1,1,1,0,0,0,0,0,0,0,0,0,6,0,0,1,1,1,1,0,3,0,0,0,1,3,0,1,0,0,1,3,0,0,3,0,1],
    [1,0,0,0,1,1,1,0,0,0,0,0,0,0,0,0,0,0,0,1,1,1,1,1,1,1,0,0,0,0,0,6,0,0,1,1,1,0,0,3,1,0,0,0,3,0,1,0,0,1,3,0,0,3,0,1],
    [1,0,0,0,1,1,1,1,0,0,0,0,0,0,0,0,0,0,0,1,1,1,1,1,1,1,1,0,0,0,0,6,0,0,0,1,1,0,0,3,1,1,1,1,3,0,1,0,1,1,3,1,1,1,1,1],
    [1,0,0,0,1,1,1,1,0,0,0,0,0,0,0,0,0,0,0,1,1,1,1,1,1,1,1,0,0,2,2,6,0,0,0,1,1,0,0,3,0,0,0,1,3,0,1,0,0,0,3,0,0,0,0,1],
    [1,0,0,0,1,1,1,1,1,1,1,1,1,1,1,2,2,2,1,1,1,1,1,1,1,1,1,0,0,0,0,6,0,0,0,1,1,1,0,3,0,0,0,1,3,0,1,0,0,0,3,0,0,0,0,1],
    [1,0,0,0,0,0,0,0,0,0,0,0,0,0,0,0,0,1,1,1,0,0,1,1,1,1,1,0,0,0,0,6,2,2,0,0,1,1,1,1,1,1,1,1,1,1,1,1,1,1,1,1,1,0,0,1],
    [1,0,0,0,0,0,0,0,0,0,0,0,0,0,0,0,1,1,1,0,0,0,0,0,0,0,0,0,0,0,0,6,0,0,0,0,0,0,0,1,1,1,1,1,1,1,1,1,1,1,0,0,0,0,0,1],
    [1,0,0,0,0,0,0,0,0,0,0,0,0,0,1,1,1,1,1,0,0,0,0,0,0,0,0,0,0,0,0,6,0,0,0,0,0,0,0,0,0,0,0,0,0,0,0,0,0,0,0,0,0,0,0,1],
    [1,1,1,1,1,1,1,1,1,1,1,1,1,1,1,1,1,1,1,1,1,1,1,1,1,1,1,1,1,1,1,1,1,1,1,1,1,1,1,1,1,1,1,1,1,1,1,1,1,1,1,1,1,1,1,1]
  ],
  "layerMap": [
    [1,1,1,1,1,1,1,1,1,1,1,1,1,1,1,1,1,1,1,1,1,1,1,1,1,1,1,1,1,1,1,1,1,1,1,1,1,1,1,1,1,1,1,1,1,1,1,1,1,1,1,1,1,1,1,1],
    [1,0,0,0,1,1,1,1,1,1,1,1,1,0,0,0,0,0,0,0,0,0,0,1,1,1,1,1,1,1,0,0,0,0,0,0,0,0,0,0,0,0,0,0,0,0,0,0,0,0,0,0,0,0,1,1],
    [1,0,0,0,1,1,1,1,1,0,0,0,0,0,0,0,0,0,0,0,0,0,0,0,0,0,0,0,0,0,0,0,0,0,0,0,0,0,0,0,0,0,0,0,0,0,0,0,0,0,0,0,0,0,0,1],
    [1,0,0,0,1,1,1,0,0,0,0,0,0,0,0,1,1,1,1,0,0,0,0,0,0,0,0,0,0,0,0,0,1,1,1,1,1,1,1,1,1,1,1,1,1,1,1,1,1,1,1,1,1,1,1,1],
    [1,0,0,0,1,0,0,0,0,0,0,1,1,1,1,1,0,0,1,1,1,1,1,0,0,0,0,0,0,0,1,1,1,0,0,0,0,0,0,1,1,1,1,1,1,1,1,1,1,1,1,1,1,1,1,1],
    [1,0,0,0,1,0,0,0,0,1,1,1,0,0,0,0,0,0,0,0,0,0,1,1,1,1,1,1,1,1,1,0,0,0,0,0,0,0,0,0,0,1,1,1,1,1,1,1,1,1,1,1,1,1,1,1],
    [1,0,0,0,1,0,0,0,0,0,0,0,0,0,0,0,0,0,0,0,0,0,0,0,0,0,0,0,0,0,0,0,0,0,0,0,0,0,0,0,0,0,1,1,1,1,1,1,1,1,1,1,1,1,1,1],
    [1,0,0,0,1,1,0,0,0,0,0,0,0,0,0,1,0,0,0,0,0,0,0,0,0,0,0,0,0,0,0,0,0,0,0,0,0,0,0,0,0,0,1,1,1,0,1,0,1,0,1,0,0,0,0,9],
    [1,0,0,0,1,1,1,0,0,0,0,0,0,0,1,1,1,0,0,0,1,1,1,0,1,1,1,0,0,0,0,0,0,0,0,0,0,0,0,0,0,0,0,0,0,0,1,0,1,0,1,0,0,0,0,9],
    [1,0,0,0,1,1,1,0,0,0,1,1,1,1,1,1,1,1,0,0,0,1,1,0,1,1,0,0,1,1,0,0,0,1,1,1,0,0,0,0,0,0,0,0,0,0,1,0,1,0,1,0,0,0,0,9],
    [1,0,0,0,1,1,1,0,0,1,1,1,1,1,1,1,1,1,1,0,0,0,0,0,0,0,0,0,1,1,1,0,0,1,1,0,0,3,0,0,0,0,1,1,1,1,1,1,1,1,1,1,1,1,1,1],
    [1,0,0,0,1,1,1,2,2,1,1,1,1,1,1,1,1,1,1,1,0,0,0,0,0,0,0,0,0,0,1,0,0,0,0,0,1,3,1,1,1,1,1,1,1,1,1,1,1,1,1,1,1,1,1,1],
    [1,0,0,0,1,1,0,0,0,0,0,0,0,0,0,1,1,1,1,1,1,0,0,0,0,0,0,0,0,0,0,0,0,0,0,1,1,3,1,1,1,1,1,1,1,1,1,1,1,1,1,1,1,1,1,1],
    [1,0,0,0,1,1,0,0,0,0,0,0,0,0,0,0,1,1,1,1,1,4,4,4,4,4,4,4,4,4,4,4,4,4,4,1,1,3,0,1,1,1,1,1,1,1,1,1,1,1,1,1,1,1,1,1],
    [1,0,0,0,1,1,0,1,1,1,0,0,0,0,0,0,0,1,1,1,1,1,1,1,1,1,1,1,1,1,1,1,1,1,1,1,1,3,0,0,0,0,0,0,0,3,1,0,0,1,3,0,0,0,0,1],
    [1,0,0,0,1,0,0,1,1,1,1,0,0,0,0,0,0,0,1,1,1,1,1,1,1,1,1,1,1,1,1,1,1,1,1,1,0,3,0,0,0,0,0,0,0,3,1,0,0,1,3,0,0,0,0,1],
    [1,0,0,0,1,0,0,0,1,1,1,0,0,0,0,0,0,0,1,1,1,1,1,1,1,1,1,1,1,1,1,1,1,1,1,0,0,1,1,1,1,1,1,1,1,3,1,1,0,1,3,1,1,1,1,1],
    [1,0,0,0,1,0,0,0,0,1,1,1,0,0,0,0,0,0,0,1,1,1,1,1,1,1,1,1,1,1,4,4,1,1,1,0,0,1,3,0,1,0,0,0,0,3,1,0,0,0,3,0,1,0,0,1],
    [1,0,0,0,1,0,0,0,0,0,1,1,0,0,2,2,0,0,0,1,1,1,1,1,1,1,1,0,0,1,1,4,1,1,0,0,1,1,3,0,0,0,0,0,0,3,0,0,0,0,3,0,1,0,0,1],
    [1,0,0,0,1,0,0,0,0,0,0,0,0,0,0,0,0,0,0,1,1,1,1,1,0,0,0,0,0,0,0,1,1,0,0,1,1,0,3,1,1,1,1,1,1,1,1,1,1,1,1,0,1,1,0,1],
    [1,0,0,0,1,0,0,0,0,0,0,0,0,0,0,0,0,0,0,1,1,1,1,0,0,0,0,0,0,1,1,1,1,1,1,1,0,0,3,0,1,0,0,0,3,0,1,0,0,1,0,0,0,3,0,1],
    [1,0,0,0,1,0,0,0,0,0,0,0,0,0,1,1,0,0,0,1,1,1,0,0,0,0,0,0,0,0,1,1,1,1,1,1,0,0,3,0,0,0,0,0,3,0,1,0,0,1,0,0,0,3,0,1],
    [1,0,0,0,1,0,0,0,0,0,1,1,0,0,0,1,0,0,0,1,1,0,0,0,0,0,0,0,0,0,0,1,0,1,1,1,1,1,1,1,1,1,1,1,3,1,1,1,1,1,1,1,1,3,1,1],
    [1,0,0,0,1,0,0,0,0,0,1,1,0,0,0,0,0,0,0,1,1,1,0,0,0,0,0,0,0,0,0,1,0,0,1,1,1,1,0,3,0,0,0,1,3,0,1,0,0,1,3,0,0,3,0,1],
    [1,0,0,0,1,1,1,0,0,0,0,0,0,0,0,0,0,0,0,1,1,1,1,1,1,1,0,0,0,0,0,1,0,0,1,1,1,0,0,3,1,0,0,0,3,0,1,0,0,1,3,0,0,3,0,1],
    [1,0,0,0,1,1,1,1,0,0,0,0,0,0,0,0,0,0,0,1,1,1,1,1,1,1,1,0,0,0,0,1,0,0,0,1,1,0,0,3,1,1,1,1,3,0,1,0,1,1,3,1,1,1,1,1],
    [1,0,0,0,1,1,1,1,0,0,0,0,0,0,0,0,0,0,0,1,1,1,1,1,1,1,1,0,0,2,2,1,0,0,0,1,1,0,0,3,0,0,0,1,3,0,1,0,0,0,3,0,0,0,0,1],
    [1,0,0,0,1,1,1,1,1,1,1,1,1,1,1,2,2,2,1,1,1,1,1,1,1,1,1,0,0,0,0,1,0,0,0,1,1,1,0,3,0,0,0,1,3,0,1,0,0,0,3,0,0,0,0,1],
    [1,0,0,0,0,0,0,0,0,0,0,0,0,0,0,0,0,1,1,1,0,0,1,1,1,1,1,0,0,0,0,1,2,2,0,0,1,1,1,1,1,1,1,1,1,1,1,1,1,1,1,1,1,0,0,1],
    [1,0,0,0,0,0,0,0,0,0,0,0,0,0,0,0,1,1,1,0,0,0,0,0,0,0,0,0,0,0,0,1,0,0,0,0,0,0,0,1,1,1,1,1,1,1,1,1,1,1,0,0,0,0,0,1],
    [1,0,0,0,0,0,0,0,0,0,0,0,0,0,1,1,1,1,1,0,0,0,0,0,0,0,0,0,0,0,0,1,0,0,0,0,0,0,0,0,0,0,0,0,0,0,0,0,0,0,0,0,0,0,0,1],
    [1,1,1,1,1,1,1,1,1,1,1,1,1,1,1,1,1,1,1,1,1,1,1,1,1,1,1,1,1,1,1,1,1,1,1,1,1,1,1,1,1,1,1,1,1,1,1,1,1,1,1,1,1,1,1,1]
  ],
  "interactiveBlocks": [
    {
      "cord": [46,8],
      "itemRequired": 2,
      "action": "disappear",
      "blockIDFollowed": 9,
      "message": "Have you met the number 0 yet?"
    },
    {
      "cord": [48,8],
      "itemRequired": 3,
      "action": "disappear",
      "blockIDFollowed": 9,
      "message": "Have you met the number 1 yet?"
    },
    {
      "cord": [50,8],
      "itemRequired": 4,
      "action": "disappear",
      "blockIDFollowed": 9,
      "message": "Have you met the number 2 yet?"
    },
    {
      "cord": [32, 19],
      "itemRequired": 1,
      "action": "appear",
      "blockIDToAppear": 7,
      "appearCord": [31, 19],
      "message": "This looks like it can interrupt the stream. If we have a lever somehow..."
    },
    {
      "cord": [55,9],
      "action": "nextLevel"
    },
    {
      "cord": [15,6],
      "action" : "dialogue",
      "message": "Water's scary! Don't go near it!",
      "duration": 5000,
      "removeAfterAction": false
    }
  ],

  "itemAtlas": "/levels/lvl2/items.png",
  "itemTypes": 5,
  "itemSpawns": [
    {
      "id": 0,
      "cord": [21,30]
    },
    {
      "id": 1,
      "cord": [41,27]
    }
  ],

  "npcAtlas": "/levels/lvl2/npcs.png",
  "spriteCount": 3,
  "npcs": [
    {
      "name": "Number 0",
      "npcID": "no0",
      "cord": [7, 30],
      "spriteID": 0,
      "dialogueID": "get0",
      "action": "giveItem",
      "itemID": 2,
      "removeAfterAction": true
    },
    {
      "name": "Number 1",
      "npcID": "no1",
      "cord": [51, 2],
      "spriteID": 1,
      "dialogueID": "get1",
      "action": "giveItem",
      "itemID": 3,
      "removeAfterAction": true
    },
    {
      "name": "Number 2",
      "npcID": "no2",
      "cord": [23, 23],
      "spriteID": 2,
      "dialogueID": "get2",
      "action": "giveItem",
      "itemID": 4,
      "removeAfterAction": true
    }
  ]
}