{
  "playerStartIndex" : [   5,  26],
  "mapSize" : [  28,  32],
  "background" : "/levels/lvl1/background.png",

  "blockAtlas" : "/levels/lvl1/blocks.png",
  "blockTypes" : 10,

  "graphicMap" : [
    [0,0,0,0,0,0,0,0,0,0,5,5,5,5,5,5,5,5,5,5,5,5,5,5,5,5,5,5],
    [0,0,0,0,0,0,4,0,0,5,5,5,5,5,5,5,5,5,5,5,5,5,5,5,5,5,5,5],
    [0,0,0,0,0,4,4,0,0,5,5,4,4,4,4,4,4,4,4,4,4,4,4,4,4,4,4,4],
    [0,0,0,0,0,4,0,0,0,0,0,0,0,0,0,0,0,0,0,0,0,0,0,0,0,0,0,4],
    [4,0,0,0,4,4,0,0,0,0,0,0,0,0,7,0,0,0,0,0,0,0,0,0,0,0,0,4],
    [4,4,0,0,4,0,0,6,6,4,4,4,4,4,7,0,4,4,4,4,4,4,4,4,4,6,6,4],
    [0,4,0,4,4,0,0,0,0,5,5,5,5,4,7,0,4,5,5,5,5,5,5,5,4,0,0,4],
    [0,4,0,4,0,0,0,0,0,0,5,5,5,4,7,0,4,5,5,5,4,4,4,4,4,0,0,4],
    [0,4,4,4,6,6,6,0,0,0,0,5,5,4,7,0,4,4,4,4,4,0,0,0,0,0,0,4],
    [0,0,4,4,0,0,0,0,0,0,0,5,5,4,7,0,4,0,0,0,0,0,0,0,0,0,0,4],
    [0,0,4,0,0,0,0,0,0,0,0,5,5,4,7,0,4,0,4,4,4,4,4,4,4,4,4,4],
    [0,4,4,6,6,6,0,0,0,0,0,5,5,4,7,0,4,0,4,5,5,5,5,5,5,5,5,5],
    [0,4,0,0,0,0,0,0,0,0,0,5,5,4,7,0,4,0,4,4,4,4,5,5,5,5,5,5],
    [0,4,0,0,0,0,0,0,0,0,0,5,5,4,7,0,0,0,0,8,0,4,4,4,5,5,5,5],
    [0,4,6,6,6,0,0,0,0,0,0,0,5,4,7,0,0,0,0,9,0,4,4,4,4,5,5,5],
    [0,4,0,0,0,0,0,0,0,0,0,0,5,4,4,4,4,4,4,4,0,0,4,4,4,5,5,5],
    [0,4,0,0,0,0,0,0,0,0,0,0,5,5,5,5,5,5,5,4,4,0,0,4,4,5,5,5],
    [1,1,1,0,0,0,0,0,0,0,0,0,0,5,5,5,5,5,5,5,4,4,0,4,4,5,5,5],
    [2,2,2,1,1,1,0,0,0,0,0,0,0,0,0,5,5,5,5,5,4,4,0,4,4,5,5,5],
    [2,2,2,2,2,2,1,0,0,0,0,0,0,0,0,0,0,7,0,0,0,4,0,4,5,5,4,0],
    [2,2,2,2,2,2,2,1,1,0,6,6,6,0,0,0,0,7,0,0,0,4,0,4,0,4,4,0],
    [3,3,3,3,3,2,2,2,2,0,0,0,0,0,6,6,6,7,4,4,4,4,0,4,4,4,0,0],
    [3,3,3,3,3,3,3,3,3,0,0,0,0,0,0,0,0,7,0,0,0,4,0,4,4,0,0,0],
    [3,3,0,0,0,0,0,0,0,0,0,0,0,0,0,0,0,7,0,0,4,4,0,4,4,0,0,0],
    [3,0,0,0,0,0,0,0,0,0,0,0,0,0,0,0,0,7,0,0,4,4,0,4,4,0,0,0],
    [3,0,0,0,0,0,0,0,0,0,0,0,0,0,0,0,0,7,0,4,4,4,0,4,4,0,0,0],
    [3,0,0,0,10,10,10,0,0,3,0,0,0,0,3,0,0,7,0,4,4,4,0,4,4,4,0,0],
    [3,0,0,1,1,1,1,1,1,3,3,0,0,3,3,0,0,4,4,4,4,4,0,4,4,4,0,0],
    [3,1,1,2,2,2,2,2,2,1,1,0,0,3,3,0,4,4,4,2,2,4,0,4,2,4,4,4],
    [1,2,2,2,2,2,2,2,2,2,2,1,1,1,1,4,4,4,2,2,2,4,0,4,2,2,4,4],
    [2,2,2,2,2,2,2,2,2,2,2,2,2,2,2,2,2,2,2,2,2,4,0,4,2,2,2,2],
    [2,2,2,2,2,2,2,2,2,2,2,2,2,2,2,2,2,2,2,2,2,4,0,4,2,2,2,2]
  ],
  "layerMap" : [
    [0,0,0,0,0,0,0,0,0,0,1,1,1,1,1,1,1,1,1,1,1,1,1,1,1,1,1,1],
    [0,0,0,0,0,0,1,0,0,1,1,1,1,1,1,1,1,1,1,1,1,1,1,1,1,1,1,1],
    [0,0,0,0,0,1,1,0,0,1,1,1,1,1,1,1,1,1,1,1,1,1,1,1,1,1,1,1],
    [0,0,0,0,0,1,0,0,0,0,0,0,0,0,0,0,0,0,0,0,0,0,0,0,0,0,0,1],
    [1,0,0,0,1,1,0,0,0,0,0,0,0,0,3,0,0,0,0,0,0,0,0,0,0,0,0,1],
    [1,1,0,0,1,0,0,2,2,1,1,1,1,1,3,0,1,1,1,1,1,1,1,1,1,2,2,1],
    [0,1,0,1,1,0,0,0,0,1,1,1,1,1,3,0,1,1,1,1,1,1,1,1,1,0,0,1],
    [0,1,0,1,0,0,0,0,0,0,1,1,1,1,3,0,1,1,1,1,1,1,1,1,1,0,0,1],
    [0,1,1,1,2,2,2,0,0,0,0,1,1,1,3,0,1,1,1,1,1,0,0,0,0,0,0,1],
    [0,0,1,1,0,0,0,0,0,0,0,1,1,1,3,0,1,0,0,0,0,0,0,0,0,0,0,1],
    [0,0,1,0,0,0,0,0,0,0,0,1,1,1,3,0,1,0,1,1,1,1,1,1,1,1,1,1],
    [0,1,1,2,2,2,0,0,0,0,0,1,1,1,3,0,1,0,1,1,1,1,1,1,1,1,1,1],
    [0,1,0,0,0,0,0,0,0,0,0,1,1,1,3,0,1,0,1,1,1,1,1,1,1,1,1,1],
    [0,1,0,0,0,0,0,0,0,0,0,1,1,1,3,0,0,0,0,1,0,1,1,1,1,1,1,1],
    [0,1,2,2,2,0,0,0,0,0,0,0,1,1,3,0,0,0,0,1,0,1,1,1,1,1,1,1],
    [0,1,0,0,0,0,0,0,0,0,0,0,1,1,1,1,1,1,1,1,0,0,1,1,1,1,1,1],
    [0,1,0,0,0,0,0,0,0,0,0,0,1,1,1,1,1,1,1,1,1,0,0,1,1,1,1,1],
    [1,1,1,0,0,0,0,0,0,0,0,0,0,1,1,1,1,1,1,1,1,1,0,1,1,1,1,1],
    [1,1,1,1,1,1,0,0,0,0,0,0,0,0,0,1,1,1,1,1,1,1,0,1,1,1,1,1],
    [1,1,1,1,1,1,1,0,0,0,0,0,0,0,0,0,0,3,0,0,0,1,0,1,1,1,1,0],
    [1,1,1,1,1,1,1,1,1,0,2,2,2,0,0,0,0,3,0,0,0,1,0,1,0,1,1,0],
    [1,1,1,1,1,1,1,1,1,0,0,0,0,0,2,2,2,3,1,1,1,1,0,1,1,1,0,0],
    [1,1,1,1,1,1,1,1,1,0,0,0,0,0,0,0,0,3,0,0,0,1,0,1,1,0,0,0],
    [1,1,0,0,0,0,0,0,0,0,0,0,0,0,0,0,0,3,0,0,1,1,0,1,1,0,0,0],
    [1,0,0,0,0,0,0,0,0,0,0,0,0,0,0,0,0,3,0,0,1,1,0,1,1,0,0,0],
    [1,0,0,0,0,0,0,0,0,0,0,0,0,0,0,0,0,3,0,1,1,1,0,1,1,0,0,0],
    [1,0,0,0,0,0,0,0,0,1,0,0,0,0,1,0,0,3,0,1,1,1,0,1,1,1,0,0],
    [1,0,0,1,1,1,1,1,1,1,1,0,0,1,1,0,0,1,1,1,1,1,0,1,1,1,0,0],
    [1,1,1,1,1,1,1,1,1,1,1,0,0,1,1,0,1,1,1,1,1,1,0,1,1,1,1,1],
    [1,1,1,1,1,1,1,1,1,1,1,1,1,1,1,1,1,1,1,1,1,1,0,1,1,1,1,1],
    [1,1,1,1,1,1,1,1,1,1,1,1,1,1,1,1,1,1,1,1,1,1,0,1,1,1,1,1],
    [1,1,1,1,1,1,1,1,1,1,1,1,1,1,1,1,1,1,1,1,1,1,0,1,1,1,1,1]
  ],
  "interactiveBlocks" : [
    {
      "cord": [19,14],
      "itemRequired" : 1,
      "action" : "disappear",
      "blockIDFollowed" : 8,
      "message": "A locked door. Look like it needs a key"
    },
    {
      "cord": [22,31],
      "itemRequired" : -1,
      "action" : "nextLevel",
      "blockIDFollowed" : -1
    },
    {
      "cord": [5,26],
      "itemRequired" : -1,
      "blockIDFollowed" : -1,
      "action" : "dialogue",
      "message": "Push [A] to move left, [D] to move right",
      "duration": 5000,
      "removeAfterAction": false
    },
    {
      "cord": [8,26],
      "itemRequired" : -1,
      "blockIDFollowed" : -1,
      "action" : "dialogue",
      "message": "Push [SPACE] to jump. Push again mid-air to double jump",
      "duration": 5000,
      "removeAfterAction": false
    },
    {
      "cord": [17,26],
      "itemRequired" : -1,
      "blockIDFollowed" : -1,
      "action" : "dialogue",
      "message": "Push [W] while at ladder to climb. [A] [D] freely when you want",
      "duration": 5000,
      "removeAfterAction": false
    },
    {
      "cord": [5,17],
      "itemRequired" : -1,
      "blockIDFollowed" : -1,
      "action" : "dialogue",
      "message": "Get on an one-way plaform from under, stay solid on it's top",
      "duration": 5000,
      "removeAfterAction": false
    },
    {
      "cord": [25,4],
      "itemRequired" : -1,
      "blockIDFollowed" : -1,
      "action" : "dialogue",
      "message": "Push [S] + [SPACE] to drop down from an one-way plaform",
      "duration": 5000,
      "removeAfterAction": false
    }
  ],

  "itemAtlas" : "/levels/lvl1/items.png",
  "itemTypes" : 2,
  "itemSpawns" : [
    {
      "id" : 1,
      "cord" : [22,9]
    },
    {
      "id" : 0,
      "cord" : [20,20]
    }
  ]
}